ASHO3	ASHLAND	SOUTHERN_OREGON_COASTAL
CVJO3	CAVE_JUNCTION	SOUTHERN_OREGON_COASTAL
GOLO3	GOLD_BEACH	SOUTHERN_OREGON_COASTAL
GPSO3	GRANTS_PASS_KAJO	SOUTHERN_OREGON_COASTAL
GSPO3	GREEN_SPRINGS_PP	SOUTHERN_OREGON_COASTAL
LEMO3	LEMOLO_LAKE	SOUTHERN_OREGON_COASTAL
MFR	MEDFORD	SOUTHERN_OREGON_COASTAL
OTH	NORTH_BEND	SOUTHERN_OREGON_COASTAL
PRSO3	PROSPECT_2SW	SOUTHERN_OREGON_COASTAL
RIDO3	RIDDLE	SOUTHERN_OREGON_COASTAL
ROGO3	ROSEBURG	SOUTHERN_OREGON_COASTAL
SXT	SEXTON_SUMMIT	SOUTHERN_OREGON_COASTAL
TKFO3	TOKETEE_FALLS	SOUTHERN_OREGON_COASTAL
WINO3	WINCHESTER_DAM	SOUTHERN_OREGON_COASTAL
WLMO3	WILLIAMS	SOUTHERN_OREGON_COASTAL
HMRO3	HART_MOUNTAIN_REF	OREGON_CLOSED_BASINS
SMMO3	SUMMER_LAKE	OREGON_CLOSED_BASINS
CVLC1	COVELO	NORTHERN_CALIFORNIA_COASTAL
EKA	EUREKA	NORTHERN_CALIFORNIA_COASTAL
FORC1	FORT_ROSS	NORTHERN_CALIFORNIA_COASTAL
FRBC1	FT_BRAGG_5N	NORTHERN_CALIFORNIA_COASTAL
GASC1	GASQUET_RS	NORTHERN_CALIFORNIA_COASTAL
SCTC1	SCOTIA	NORTHERN_CALIFORNIA_COASTAL
CHQO3	CHILOQUIN_7NW	UPPER_KLAMATH
CRLO3	CRATER_LAKE_NP	UPPER_KLAMATH
GBZO3	GERBER	UPPER_KLAMATH
HOWO3	HOWARD_PRAIRIE	UPPER_KLAMATH
KENO3	KENO	UPPER_KLAMATH
LMT	KLAMATH_FALLS	UPPER_KLAMATH
COPC1	COPCO_#1_DAM	UPPER_KLAMATH
BBAC1	BIG_BAR_4E	LOWER_KLAMATH
FOJC1	FORT_JONES	LOWER_KLAMATH
HPAC1	HOOPA	LOWER_KLAMATH
HPYC1	HAPPY_CAMP	LOWER_KLAMATH
HYAC1	HYAMPOM	LOWER_KLAMATH
MTHC1	MT._HEBRON_RS	LOWER_KLAMATH
ORLC1	ORLEANS	LOWER_KLAMATH
STGC1	LAVA_BEDS_NM	LOWER_KLAMATH
TRHC1	TRINITY_RIVER_HATCHERY	LOWER_KLAMATH
TULC1	TULE_LAKE	LOWER_KLAMATH
WEAC1	WEAVERVILLE	LOWER_KLAMATH
WLLC1	WILLOW_CREEK_1NW	LOWER_KLAMATH
YKAC1	YREKA	LOWER_KLAMATH
ANGC1	ANGWIN_PACIFIC_UNION_COLLEGE	RUSSIAN...NAPA...SAN_FRANCISCO_BAY
CLTC1	CALISTOGA	RUSSIAN...NAPA...SAN_FRANCISCO_BAY
FFDC1	FAIRFIELD	RUSSIAN...NAPA...SAN_FRANCISCO_BAY
GRNC1	GRATON	RUSSIAN...NAPA...SAN_FRANCISCO_BAY
KENC1	KENTFIELD	RUSSIAN...NAPA...SAN_FRANCISCO_BAY
MHMC1	MOUNT_HAMILTON	RUSSIAN...NAPA...SAN_FRANCISCO_BAY
NSHC1	NAPA_STATE_HOSPITAL	RUSSIAN...NAPA...SAN_FRANCISCO_BAY
OAMC1	OAKLAND_MUSEUM	RUSSIAN...NAPA...SAN_FRANCISCO_BAY
PORC1	POTTER_VALLEY_PH	RUSSIAN...NAPA...SAN_FRANCISCO_BAY
SFO	SAN_FRANCISCO_AIRPORT	RUSSIAN...NAPA...SAN_FRANCISCO_BAY
SFOC1	DOWNTOWN_SAN_FRANCISCO	RUSSIAN...NAPA...SAN_FRANCISCO_BAY
SJC	SAN_JOSE_INTL_AIRPORT	RUSSIAN...NAPA...SAN_FRANCISCO_BAY
UKIC1	UKIAH_4WSW	RUSSIAN...NAPA...SAN_FRANCISCO_BAY
UKI	UKIAH_ASOS	RUSSIAN...NAPA...SAN_FRANCISCO_BAY
4LW	LAKEVIEW	SACRAMENTO...YUBA...FEATHER...AMERICAN
AAT	ALTURAS	SACRAMENTO...YUBA...FEATHER...AMERICAN
ADNC1	ADIN	SACRAMENTO...YUBA...FEATHER...AMERICAN
AUBC1	AUBURN	SACRAMENTO...YUBA...FEATHER...AMERICAN
BODC1	BOWMAN_DAM	SACRAMENTO...YUBA...FEATHER...AMERICAN
BUCC1	BUCKS_CREEK	SACRAMENTO...YUBA...FEATHER...AMERICAN
BUKC1	BUCKHORN	SACRAMENTO...YUBA...FEATHER...AMERICAN
CANC1	CANYON_DAM	SACRAMENTO...YUBA...FEATHER...AMERICAN
CHEC1	CHESTER	SACRAMENTO...YUBA...FEATHER...AMERICAN
CHUC1	CHICO_UNIVERSITY_FARM	SACRAMENTO...YUBA...FEATHER...AMERICAN
CLGC1	COLGATE_PH	SACRAMENTO...YUBA...FEATHER...AMERICAN
COFC1	COLFAX	SACRAMENTO...YUBA...FEATHER...AMERICAN
DAVC1	DAVIS_EXPERIMENTAL_FARM	SACRAMENTO...YUBA...FEATHER...AMERICAN
DESC1	DE_SABLA	SACRAMENTO...YUBA...FEATHER...AMERICAN
DUNC1	DUNSMUIR	SACRAMENTO...YUBA...FEATHER...AMERICAN
DWFC1	DOWNIEVILLE	SACRAMENTO...YUBA...FEATHER...AMERICAN
FSTC1	FORESTHILL_RS	SACRAMENTO...YUBA...FEATHER...AMERICAN
GEOC1	GEORGETOWN_RS	SACRAMENTO...YUBA...FEATHER...AMERICAN
GLRC1	GOLD_RUN_2SW	SACRAMENTO...YUBA...FEATHER...AMERICAN
GRAC1	GRASS_VALLEY_NO._2	SACRAMENTO...YUBA...FEATHER...AMERICAN
GREC1	GREENVILLE_RS	SACRAMENTO...YUBA...FEATHER...AMERICAN
HATC1	HAT_CREEK	SACRAMENTO...YUBA...FEATHER...AMERICAN
HLEC1	HARRY_L_ENGLEBRIGHT_DAM	SACRAMENTO...YUBA...FEATHER...AMERICAN
HRRC1	HARRISON_GULCH_RS	SACRAMENTO...YUBA...FEATHER...AMERICAN
LSPC1	LAKE_SPAULDING	SACRAMENTO...YUBA...FEATHER...AMERICAN
MCLC1	MCCLOUD	SACRAMENTO...YUBA...FEATHER...AMERICAN
MHS	MT._SHASTA	SACRAMENTO...YUBA...FEATHER...AMERICAN
MINC1	MINERAL	SACRAMENTO...YUBA...FEATHER...AMERICAN
MNZC1	MANZANITA_LAKE	SACRAMENTO...YUBA...FEATHER...AMERICAN
NICC1	NICOLAUS	SACRAMENTO...YUBA...FEATHER...AMERICAN
NVDC1	NEVADA_CITY	SACRAMENTO...YUBA...FEATHER...AMERICAN
ONDC1	ORLAND	SACRAMENTO...YUBA...FEATHER...AMERICAN
PCHC1	PACIFIC_HOUSE	SACRAMENTO...YUBA...FEATHER...AMERICAN
PLCC1	PLACERVILLE	SACRAMENTO...YUBA...FEATHER...AMERICAN
PLUC1	PLUMAS_EUREKA_SP	SACRAMENTO...YUBA...FEATHER...AMERICAN
PRAC1	PORTOLA	SACRAMENTO...YUBA...FEATHER...AMERICAN
PRDC1	PARADISE	SACRAMENTO...YUBA...FEATHER...AMERICAN
PTRC1	PIT_RIVER_PH1	SACRAMENTO...YUBA...FEATHER...AMERICAN
QCYC1	QUINCY	SACRAMENTO...YUBA...FEATHER...AMERICAN
RBL	RED_BLUFF_AP	SACRAMENTO...YUBA...FEATHER...AMERICAN
SERC1	SIERRAVILLE	SACRAMENTO...YUBA...FEATHER...AMERICAN
SHDC1	SHASTA_DAM	SACRAMENTO...YUBA...FEATHER...AMERICAN
SLPC1	SLY_PARK	SACRAMENTO...YUBA...FEATHER...AMERICAN
SMTC1	SACRAMENTO_5_ESE	SACRAMENTO...YUBA...FEATHER...AMERICAN
SODC1	SODA_SPRINGS	SACRAMENTO...YUBA...FEATHER...AMERICAN
STOC1	STONY_GORGE	SACRAMENTO...YUBA...FEATHER...AMERICAN
STYC1	STRAWBERRY_VALLEY	SACRAMENTO...YUBA...FEATHER...AMERICAN
TWLC1	CAPLES_LAKE	SACRAMENTO...YUBA...FEATHER...AMERICAN
VOLC1	VOLTA_PH	SACRAMENTO...YUBA...FEATHER...AMERICAN
VTNC1	VINTON	SACRAMENTO...YUBA...FEATHER...AMERICAN
WDLC1	WOODLAND	SACRAMENTO...YUBA...FEATHER...AMERICAN
WSKC1	WHISKEYTOWN_RES	SACRAMENTO...YUBA...FEATHER...AMERICAN
ABYC1	AUBERRY	SAN_JOAQUIN
ARNC1	CALAVERAS_BIG_TREES	SAN_JOAQUIN
CHVC1	CHERRY_VALLEY	SAN_JOAQUIN
CMPC1	CAMP_PARDEE	SAN_JOAQUIN
EXQC1	EXCHEQUER_DAM	SAN_JOAQUIN
FDDC1	FIDDLETOWN_DEXTER_RANCH	SAN_JOAQUIN
FLOC1	FLORENCE_LAKE	SAN_JOAQUIN
FRAC1	FRIANT_GOVERNMENT_CAMP	SAN_JOAQUIN
GRVC1	GROVELAND_RS	SAN_JOAQUIN
HETC1	HETCH_HETCHY	SAN_JOAQUIN
HNTC1	HUNTINGTON_LAKE	SAN_JOAQUIN
LOSC1	LOS_BANOS	SAN_JOAQUIN
MCEC1	MERCED	SAN_JOAQUIN
MDRC1	MADERA	SAN_JOAQUIN
MRIC1	MARIPOSA_RS	SAN_JOAQUIN
NMDC1	NEW_MELONES_DAM_HQ	SAN_JOAQUIN
NOFC1	NORTH_FORK_RS	SAN_JOAQUIN
PANC1	PANOCHE_2W	SAN_JOAQUIN
SCKC1	STOCKTON_FIRE_STA_4	SAN_JOAQUIN
SONC1	SONORA	SAN_JOAQUIN
SPGC1	SALT_SPRINGS_PH	SAN_JOAQUIN
TIGC1	TIGER_CREEK_PH	SAN_JOAQUIN
TRPC1	TRACY_PUMPING_PLANT	SAN_JOAQUIN
WSTC1	WEST_POINT	SAN_JOAQUIN
YNPC1	SOUTH_ENTRANCE_YOSEMITE	SAN_JOAQUIN
YPQC1	YOSEMITE_PARK_HEADQUARTERS	SAN_JOAQUIN
ASHC1	ASH_MOUNTAIN	KERN...TULE...KAWEAH...KINGS
ATWC1	ATWELL_CAMP	KERN...TULE...KAWEAH...KINGS
BFL	BAKERSFIELD	KERN...TULE...KAWEAH...KINGS
BTPC1	BEAR_TRAP_MEADOW	KERN...TULE...KAWEAH...KINGS
DNPC1	BALCH_PH	KERN...TULE...KAWEAH...KINGS
EGCC1	EAGLE_CREEK	KERN...TULE...KAWEAH...KINGS
GNFC1	GIANT_FOREST	KERN...TULE...KAWEAH...KINGS
GNNC1	GLENNVILLE	KERN...TULE...KAWEAH...KINGS
GRGC1	GRANT_GROVE	KERN...TULE...KAWEAH...KINGS
HCKC1	HOCKETT_MEADOW	KERN...TULE...KAWEAH...KINGS
HSSC1	HOSSACK	KERN...TULE...KAWEAH...KINGS
ISAC1	LAKE_ISABELLA_DAM	KERN...TULE...KAWEAH...KINGS
LDGC1	LODGEPOLE	KERN...TULE...KAWEAH...KINGS
MNHC1	MOUNTAIN_HOME	KERN...TULE...KAWEAH...KINGS
PFTC1	PINE_FLAT_DAM	KERN...TULE...KAWEAH...KINGS
RGCC1	ROGERS_CAMP	KERN...TULE...KAWEAH...KINGS
SCSC1	LAKE_SUCCESS_DAM	KERN...TULE...KAWEAH...KINGS
TMDC1	TERMINUS_DAM	KERN...TULE...KAWEAH...KINGS
TREC1	THREE_RIVER_EDISON_PH_#1	KERN...TULE...KAWEAH...KINGS
CNGC1	COALINGA	TULARE-BUENA_VISTA_LAKES
FAT	FRESNO_AIR_TERMINAL	TULARE-BUENA_VISTA_LAKES
HJO	HANFORD	TULARE-BUENA_VISTA_LAKES
LEMC1	LEMON_COVE	TULARE-BUENA_VISTA_LAKES
LINC1	LINDSAY	TULARE-BUENA_VISTA_LAKES
VISC1	VISALIA	TULARE-BUENA_VISTA_LAKES
WASC1	WASCO	TULARE-BUENA_VISTA_LAKES
BISC1	BIG_SUR_STATE_PARK	CENTRAL_CALIFORNIA_COASTAL
CCAC1	CACHUMA_DAM	CENTRAL_CALIFORNIA_COASTAL
HOLC1	HOLLISTER	CENTRAL_CALIFORNIA_COASTAL
JUNC1	JUNCAL_DAM	CENTRAL_CALIFORNIA_COASTAL
KICC1	KING_CITY	CENTRAL_CALIFORNIA_COASTAL
PRB	PASO_ROBLES	CENTRAL_CALIFORNIA_COASTAL
SAEC1	SAN_CLEMENTE_DAM	CENTRAL_CALIFORNIA_COASTAL
SBA	SANTA_BARBARA	CENTRAL_CALIFORNIA_COASTAL
SBPC1	SAN_LUIS_OBISPO	CENTRAL_CALIFORNIA_COASTAL
SCRC1	SANTA_CRUZ	CENTRAL_CALIFORNIA_COASTAL
SMX	SANTA_MARIA	CENTRAL_CALIFORNIA_COASTAL
SNSC1	SALINAS_NO._2	CENTRAL_CALIFORNIA_COASTAL
WVIC1	WATSONVILLE_WATERWORKS	CENTRAL_CALIFORNIA_COASTAL
BBLC1	BIG_BEAR_LAKE_F.S.	SOUTHERN_CALIFORNIA_COASTAL
CQT	DOWNTOWN_LA	SOUTHERN_CALIFORNIA_COASTAL
CUYC1	CUYAMACA	SOUTHERN_CALIFORNIA_COASTAL
ELPC1	EL_CAPITAN_DAM	SOUTHERN_CALIFORNIA_COASTAL
EORC1	ELSINORE	SOUTHERN_CALIFORNIA_COASTAL
HNWC1	HENSHAW_DAM	SOUTHERN_CALIFORNIA_COASTAL
LAX	LA_INT'L_AIRPORT	SOUTHERN_CALIFORNIA_COASTAL
LGB	LONG_BEACH	SOUTHERN_CALIFORNIA_COASTAL
LOX	OXNARD	SOUTHERN_CALIFORNIA_COASTAL
OJAC1	OJAI	SOUTHERN_CALIFORNIA_COASTAL
MWS	MOUNT_WILSON	SOUTHERN_CALIFORNIA_COASTAL
OCNC1	OCEANSIDE_MARINA	SOUTHERN_CALIFORNIA_COASTAL
SAN	LINDBERGH_FIELD	SOUTHERN_CALIFORNIA_COASTAL
STAC1	SANTA_ANA_FS	SOUTHERN_CALIFORNIA_COASTAL
CEDC1	CEDARVILLE	NORTH_AND_CENTRAL_LAHONTAN
DOLC1	DOYLE_4SSE	NORTH_AND_CENTRAL_LAHONTAN
DOYC1	DOYLE	NORTH_AND_CENTRAL_LAHONTAN
FOBC1	FORT_BIDWELL	NORTH_AND_CENTRAL_LAHONTAN
JESC1	JESS_VALLEY	NORTH_AND_CENTRAL_LAHONTAN
Q63	SUTCLIFFE-PYRAMID_LK	NORTH_AND_CENTRAL_LAHONTAN
SNVC1	SUSANVILLE	NORTH_AND_CENTRAL_LAHONTAN
STDN2	STEAD	NORTH_AND_CENTRAL_LAHONTAN
SVEC1	SUSANVILLE_1_WNW	NORTH_AND_CENTRAL_LAHONTAN
WAWN2	WADSWORTH_4N	NORTH_AND_CENTRAL_LAHONTAN
WTNN2	WELLINGTON	NORTH_AND_CENTRAL_LAHONTAN
BDEC1	BODIE	LAKE_TAHOE...TRUCKEE...CARSON...WALKER
BOCC1	BOCA_RESERVOIR	LAKE_TAHOE...TRUCKEE...CARSON...WALKER
BPTC1	BRIDGEPORT	LAKE_TAHOE...TRUCKEE...CARSON...WALKER
CRCN2	CARSON_CITY	LAKE_TAHOE...TRUCKEE...CARSON...WALKER
DAGN2	DAGGET_PASS	LAKE_TAHOE...TRUCKEE...CARSON...WALKER
DONC1	DONNER_MEM_SP	LAKE_TAHOE...TRUCKEE...CARSON...WALKER
FEXN2	FALLON_EXPER_STATION	LAKE_TAHOE...TRUCKEE...CARSON...WALKER
GLBN2	GLENBROOK	LAKE_TAHOE...TRUCKEE...CARSON...WALKER
HTHN2	HAWTHORNE	LAKE_TAHOE...TRUCKEE...CARSON...WALKER
MINN2	MINDEN	LAKE_TAHOE...TRUCKEE...CARSON...WALKER
RNO	RENO	LAKE_TAHOE...TRUCKEE...CARSON...WALKER
SMIN2	SMITH_6N	LAKE_TAHOE...TRUCKEE...CARSON...WALKER
SRKN2	SPARKS	LAKE_TAHOE...TRUCKEE...CARSON...WALKER
TAHC1	TAHOE_CITY	LAKE_TAHOE...TRUCKEE...CARSON...WALKER
TKEC1	TRUCKEE_RS	LAKE_TAHOE...TRUCKEE...CARSON...WALKER
TPLN2	TOPAZ_LAKE_4N	LAKE_TAHOE...TRUCKEE...CARSON...WALKER
VRCN2	VIRGINIA_CITY	LAKE_TAHOE...TRUCKEE...CARSON...WALKER
WABN2	WABUSKA_6SE	LAKE_TAHOE...TRUCKEE...CARSON...WALKER
YRGN2	YERINGTON	LAKE_TAHOE...TRUCKEE...CARSON...WALKER
BARC1	BARSTOW	MOJAVE...MONO_LAKE...SALTON_SEA
BIH	BISHOP_AP	MOJAVE...MONO_LAKE...SALTON_SEA
DEVC1	DEATH_VALLEY	MOJAVE...MONO_LAKE...SALTON_SEA
ELLC1	ELLERY_LAKE	MOJAVE...MONO_LAKE...SALTON_SEA
FMTC1	FAIRMONT	MOJAVE...MONO_LAKE...SALTON_SEA
GEMC1	GEM_LAKE	MOJAVE...MONO_LAKE...SALTON_SEA
HEEC1	HAIWEE	MOJAVE...MONO_LAKE...SALTON_SEA
INDC1	INDEPENDENCE	MOJAVE...MONO_LAKE...SALTON_SEA
IPL	IMPERIAL	MOJAVE...MONO_LAKE...SALTON_SEA
LASC1	LAKE_SABRINA	MOJAVE...MONO_LAKE...SALTON_SEA
LEVC1	LEE_VINING	MOJAVE...MONO_LAKE...SALTON_SEA
LKAC1	LAKE_ARROWHEAD_F.S.	MOJAVE...MONO_LAKE...SALTON_SEA
MOJC1	MOJAVE	MOJAVE...MONO_LAKE...SALTON_SEA
NLDC1	NILAND	MOJAVE...MONO_LAKE...SALTON_SEA
PMD	PALMDALE	MOJAVE...MONO_LAKE...SALTON_SEA
PSP	PALM_SPRINGS	MOJAVE...MONO_LAKE...SALTON_SEA
RANC1	KERN_COUNTY_FD	MOJAVE...MONO_LAKE...SALTON_SEA
SOUC1	SOUTH_LAKE	MOJAVE...MONO_LAKE...SALTON_SEA
TYEC1	TWENTYNINE_PALMS	MOJAVE...MONO_LAKE...SALTON_SEA
B23	BATTLE_MOUNTAIN	HUMBOLDT
BOWN2	BEOWAWE	HUMBOLDT
EKO	ELKO	HUMBOLDT
GIBN2	GIBBS_RANCH	HUMBOLDT
IMLN2	IMLAY	HUMBOLDT
JIGN2	JIGGS_8SSE	HUMBOLDT
LOVN2	LOVELOCK	HUMBOLDT
RYPN2	RYE_PATCH_DAM	HUMBOLDT
SFKN2	SOUTH_FORK_SP	HUMBOLDT
WMC	WINNEMUCCA	HUMBOLDT
DUFN2	DUFURRENA_(SHELDON)	BLACK_ROCK_DESERT
KRVN2	KINGS_RIVER_VALLEY	BLACK_ROCK_DESERT
LCRN2	LEONARD_CREEK_RANCH	BLACK_ROCK_DESERT
MCDN2	MCDERMITT	BLACK_ROCK_DESERT
ORVN2	OROVADA_4WSW	BLACK_ROCK_DESERT
ARTN2	ARTHUR_4NW	CENTRAL_NEVADA_DESERT
BLEN2	BLUE_EAGLE_RANCH	CENTRAL_NEVADA_DESERT
DYRN2	DYER	CENTRAL_NEVADA_DESERT
EKAN2	EUREKA	CENTRAL_NEVADA_DESERT
ELY	ELY	CENTRAL_NEVADA_DESERT
LAGN2	LAGES	CENTRAL_NEVADA_DESERT
MCGN2	MCGILL	CENTRAL_NEVADA_DESERT
MIDN2	MIDDLEGATE	CENTRAL_NEVADA_DESERT
MNAN2	MINA	CENTRAL_NEVADA_DESERT
PAHN2	PAHRUMP	CENTRAL_NEVADA_DESERT
RBLN2	RUBY_LAKE	CENTRAL_NEVADA_DESERT
RTHN2	RUTH	CENTRAL_NEVADA_DESERT
SKVN2	SMOKEY_VALLEY	CENTRAL_NEVADA_DESERT
SLVN2	SILVERPEAK	CENTRAL_NEVADA_DESERT
TPH	TONOPAH	CENTRAL_NEVADA_DESERT
AWH	WILDHORSE_RESERVOIR	SNAKE_AND_COLUMBIA
JPTN2	JACKPOT	SNAKE_AND_COLUMBIA
OLEO3	ODELL_LAKE	SNAKE_AND_COLUMBIA
TUSN2	TUSCARORA	SNAKE_AND_COLUMBIA
BLH	BLYTHE	LOWER_COLORADO
BULA3	BULLHEAD_CITY	LOWER_COLORADO
CALN2	CALIENTE	LOWER_COLORADO
DNWN2	DESERT_NTL_WILDLIFE_REF	LOWER_COLORADO
EED	NEEDLES	LOWER_COLORADO
HIKN2	HIKO	LOWER_COLORADO
LAUN2	LAUGHLIN	LOWER_COLORADO
LAVU1	LA_VERKIN	LOWER_COLORADO
LHCA3	LAKE_HAVASU_CITY	LOWER_COLORADO
LUNN2	LUND	LOWER_COLORADO
SGUU1	ST._GEORGE	LOWER_COLORADO
SPVN2	SPRING_VALLEY_STATE_PA	LOWER_COLORADO
SRCN2	SEARCHLIGHT	LOWER_COLORADO
SUNN2	SUNNYSIDE	LOWER_COLORADO
VEF	LAS_VEGAS	LOWER_COLORADO
VEYU1	VEYO_POWER_HOUSE	LOWER_COLORADO
VOFN2	VALLEY_FO_FIRE_SP	LOWER_COLORADO
WUPA3	WIKIEUP	LOWER_COLORADO
ENV	WENDOVER	GREAT_SALT_LAKE
LENN2	GREAT_BASIN_N_P	GREAT_SALT_LAKE
MNTN2	MONTELLO	GREAT_SALT_LAKE
CDEU1	CEDAR_CITY_5E	ESCALANTE_DESERT
EMRU1	ENTERPRISE	ESCALANTE_DESERT
SCOC1	SCOTIA	NORTHERN_CALIFORNIA_COASTAL
UKHC1	UKIAH_FIRE_DEPT	RUSSIAN...NAPA...SAN_FRANCISCO_BAY
DWNC1	DOWNIEVILLE	SACRAMENTO...YUBA...FEATHER...AMERICAN
HENC1	HENSHAW_DAM	SOUTHERN_CALIFORNIA_COASTAL
PASO3	PAISLEY	OREGON_CLOSED_BASINS
SVLO3	SILVER_LAKE	OREGON_CLOSED_BASINS
CHEO3	CHEMULT	UPPER_KLAMATH
CHNC1	CALLAHAN	LOWER_KLAMATH
TRAC1	TRACY_CARBONA	SAN_JOAQUIN
CEC	CRESCENT_CITY_ASOS	NORTHERN_CALIFORNIA_COASTAL
BLU	BLUE_CANYON	SACRAMENTO...YUBA...FEATHER...AMERICAN
MOD	MODESTO_AP	SAN_JOAQUIN
PRPC1	PIT_RIVER_PH5	SACRAMENTO...YUBA...FEATHER...AMERICAN
BNYC1	BURNEY	SACRAMENTO...YUBA...FEATHER...AMERICAN
SAC	SACRAMENTO_AP	SACRAMENTO...YUBA...FEATHER...AMERICAN
DTHN2	DEETH	HUMBOLDT
4BK	BROOKINGS	SOUTHERN_OREGON_COASTAL
CECC1	CRESCENT_CITY_3NNW	NORTHERN_CALIFORNIA_COASTAL
GCSC1	GRIZZLY_CREEK_SP	NORTHERN_CALIFORNIA_COASTAL
OPCC1	PRAIRIE_CREEK_SP	NORTHERN_CALIFORNIA_COASTAL
RIHC1	RICHARDSON_GROVE_SP	NORTHERN_CALIFORNIA_COASTAL
WTSC1	WILLITS_1NE	NORTHERN_CALIFORNIA_COASTAL
BLIO3	BLY_4SE	UPPER_KLAMATH
HLDC1	HEALDSBURG_FIRE_DEPT	RUSSIAN...NAPA...SAN_FRANCISCO_BAY
STSC1	SANTA_ROSA	RUSSIAN...NAPA...SAN_FRANCISCO_BAY
ALTC1	ALTURAS	SACRAMENTO...YUBA...FEATHER...AMERICAN
BRRC1	BRUSH_CREEK_RS	SACRAMENTO...YUBA...FEATHER...AMERICAN
CBYC1	CANBY_3SW	SACRAMENTO...YUBA...FEATHER...AMERICAN
CHAC1	CHALLENGE_RS	SACRAMENTO...YUBA...FEATHER...AMERICAN
NCOC1	NICOLAUS	SACRAMENTO...YUBA...FEATHER...AMERICAN
ROMC1	ROUND_MOUNTAIN	SACRAMENTO...YUBA...FEATHER...AMERICAN
WDDC1	WOODLAND	SACRAMENTO...YUBA...FEATHER...AMERICAN
BCRC1	BIG_CREEK_PH_#1	SAN_JOAQUIN
MATC1	MATHER	SAN_JOAQUIN
KVLC1	KERN_RIVER_PH_#3	KERN...TULE...KAWEAH...KINGS
PRTC1	PORTERVILLE	TULARE-BUENA_VISTA_LAKES
LSLC1	LOS_ALAMOS	CENTRAL_CALIFORNIA_COASTAL
PRSC1	PRIEST_VALLEY	CENTRAL_CALIFORNIA_COASTAL
LAGC1	LAGUNA_BEACH	SOUTHERN_CALIFORNIA_COASTAL
SPLC1	SANTA_PAULA	SOUTHERN_CALIFORNIA_COASTAL
FRNN2	FERNLEY	NORTH_AND_CENTRAL_LAHONTAN
BEAN2	BEATTY_8N	MOJAVE...MONO_LAKE...SALTON_SEA
NID	CHINA_LAKE_ARMITAGE	MOJAVE...MONO_LAKE...SALTON_SEA
GOLN2	GOLCONDA	HUMBOLDT
PRDN2	PARADISE_VALLEY	HUMBOLDT
RRRN2	REESE_RIVER_O'TOOLE	HUMBOLDT
BDRN2	BOULDER_CITY	CENTRAL_NEVADA_DESERT
OASN2	OASIS	CENTRAL_NEVADA_DESERT
SSHN2	SHOSHONE	CENTRAL_NEVADA_DESERT
GUNU1	GUNLOCK_PH	LOWER_COLORADO
PWMN2	PAHRANAGAT_WILDLIFE_REF	LOWER_COLORADO
YUM	YUMA	LOWER_COLORADO
EGNN2	ELGIN	LOWER_COLORADO
CCHC1	CACHUMA_DAM	CENTRAL_CALIFORNIA_COASTAL
JNLC1	JUNCAL_DAM	CENTRAL_CALIFORNIA_COASTAL
O87	SHELTER_COVE	NORTHERN_CALIFORNIA_COASTAL
STNC1	STANDISH_HICKEY_SP	NORTHERN_CALIFORNIA_COASTAL
CFFC1	COFFEE_CREEK_RS	LOWER_KLAMATH
HFKC1	HAYFORK_2W	LOWER_KLAMATH
KLAC1	KLAMATH	LOWER_KLAMATH
OROC1	OROVILLE	SACRAMENTO...YUBA...FEATHER...AMERICAN
COAC1	COARSEGOLD_1_SW	SAN_JOAQUIN
SLDC1	LOS_BANOS	SAN_JOAQUIN
LANN2	LAHONTAN_DAM	LAKE_TAHOE...TRUCKEE...CARSON...WALKER
MKLC1	MARKLEEVILLE	LAKE_TAHOE...TRUCKEE...CARSON...WALKER
SGHC1	SAGEHEN_CREEK	LAKE_TAHOE...TRUCKEE...CARSON...WALKER
INYC1	INYOKERN-KERN_CO._FD	MOJAVE...MONO_LAKE...SALTON_SEA
PIVN2	PINE_VALLEY	HUMBOLDT
U31	AUSTIN	HUMBOLDT
CLVN2	CLOVER_VALLEY	CENTRAL_NEVADA_DESERT
DNDN2	DIAMOND_VALLEY	CENTRAL_NEVADA_DESERT
GDFN2	GOLDFIELD	CENTRAL_NEVADA_DESERT
TWSN2	TWIN_SPRING_-_FALLINI	CENTRAL_NEVADA_DESERT
MCDO3	MCDERMITT	SNAKE_AND_COLUMBIA
SILI1	SILVER_CITY	SNAKE_AND_COLUMBIA
YUCA3	YUCCA_1_NNE	LOWER_COLORADO
COPO3	COPPER_4NE	SOUTHERN_OREGON_COASTAL
DNON2	DENIO	OREGON_CLOSED_BASINS
FOLC1	FOLSOM_DAM	SACRAMENTO...YUBA...FEATHER...AMERICAN
Q67	TAHOE_CITY_USCG	LAKE_TAHOE...TRUCKEE...CARSON...WALKER
WELN2	WELLS	HUMBOLDT
MTNN2	MOUNTAIN_CITY	SNAKE_AND_COLUMBIA
PION2	PIOCHE	LOWER_COLORADO
MLFU1	MILFORD	ESCALANTE_DESERT
PRBC1	PASO_ROBLES	CENTRAL_CALIFORNIA_COASTAL
SBAC1	SANTA_BARBARA	CENTRAL_CALIFORNIA_COASTAL
PMDC1	PALMDALE	MOJAVE...MONO_LAKE...SALTON_SEA
SBOC1	SAN_BERNARDINO_FS	SOUTHERN_CALIFORNIA_COASTAL
SGSC1	SAUGUS_PH_#1	SOUTHERN_CALIFORNIA_COASTAL
LAMN2	LAMOILLE_YOST	HUMBOLDT
MODU1	MODENA	ESCALANTE_DESERT
